2012 키즈 초이스 어워드
 초록 물감 범벅의 축제행사 제 25회 니켈로디언 키즈 초이스 어워드(KCA)가 3월 31일 방송됐을 때 이 프로그램을 시청한 사람의 숫자는 1,100만 명을 넘었다. 입장권을 구하기가 매우 어려운 이 행사의 행사장에는 미 영부인 미셀 오바마 여사와 홀 베리, 그리고 한국의 원더걸스 등을 포함한 유명인사가 참석했다.
 연례 행사인 KCA는 니켈로디언 방송 시청자들의 투표로 당 해 최고의 TV, 영화, 음악을 선정해 시상한다. 수상자들은 속이 빈 오렌지 색깔 비행선 모형을 받는데 만화경으로도 쓸 수 있다.
 올해는 이제까지 가장 많은 KCA 상을 수상한 윌 스미스가 시상식을 진행하는 영예를 안았다. 특별 손님이었던 미셀 오바마 여사 또한 올해 행사에 연사로 참석했다. 오바마 여사는 올해 빅 헬프 상을 테일러 스위프트에게 수여했다.
 다른 시상식과 달리 청소년층을 대상으로 한 이 시상식 행사는 녹색 물감 맞기 등 다양한 스턴트 행사가 준비되어 있다. 2002년부터 올림픽 참가 선수, 극한 스포츠인과 기타 저돌적인 참가자들이 녹색 물감 때리기 등을 비롯한 많은 묘기를 선보인다. 처음 묘기는 BMX 프로 바이커 데이브 미라가 시작했다. 그는 녹색 물감 5,000 갤런이 들어있는 통에 착지하기 전 자신의 공중 두 바퀴 거꾸로 돌기 기록을 경신했다.
 전반적으로 하락하는 시청률을 보이고 있는 여타 시상식들과 달리 KCA 시청률은 지속적으로 상승해 왔고 2,200만 명이 투표하여 시상식 투표 기록을 경신했음은 말할 것도 없다. KCA가 다른 시상식과 차별화되는 또 다른 점에 수상자 발표 방식이 있다. 기존 봉투에서 수상자 이름을 꺼내 발표하는 방식과 달리 KCA는 풍선, 티셔츠, 모델, 초대형 편지, 스티커 등 여러 가지 방법들이 동원돼 왔다.
 올해의 수상자 명단
 최고 TV 쇼 - 빅토리어스
 최고 TV 배우(남) - 제이크 쇼트
 최고 TV 배우(여) - 셀레나 고메즈
 최고 TV 조연 - 제넷 맥커디
 최고 리얼리티 쇼 - 와이프아웃
 최고 만화 - 스폰지밥
 최고 영화 - 앨빈과 슈퍼밴드 (Alvin and the Chipmunks)
 최고 영화 배우(남) - 아담 샌들러
 최고 영화 배우(여) - 크리슨 스튜어트
 빅 헬프 상 - 테일러 스위프트
 최고 애니메이션 영화 - 장화 신은 고양이
 최고 목소리 및 애니메이션 영화 - 케이티 페리
 최고 싸움꾼 - 테일러 로트너
 최고 운동선수(남) - 팀 티보
 최고 운동선수(여) - 대니카 패트릭
 최고 도서 - 윔피 키드 다이어리
 최고 비디오 게임 - 저스트 댄스 3
 최고 그룹 - 빅타임러시
 최고 가수(남) - 저스틴 비버
 최고 가수(여) - 셀레나 고메즈
 최고 노래 - 파티락앤섬 (가수-LMFAO)
 더 많은 사진은 3p 포토뉴스에서 볼 수 있다.
 빅헬프 상
 빅그린헬프 상이라 알려졌던 '빅 헬프 상'은 환경 보호에 힘써 온 유명인사에게 수여된다. 이전 수상자로 레오나르도 디카프리오(2009), 미셀 오바마(2010), 저스틴 팀버레이크(2011)이 있다.
